###############
#P  ** E      #
# #*# # # # # #
#   ** ** #** #
# # # # # # # #
#     E  ** # #
# # # # # # # #
#   ** ** #   #
# # # # # # # #
#      E      #
#   ** ** #  *#
#   ** ** #  *#
#   ** D* #  *#
#   ** ** #  *#
###############