###############
#P  ** E      #
# #****       #
#   ** ** #D* #
# # # # # # # #
#     E  ** # #
# # # # # # # #
#   ** ** #   #
# # # # # # # #
#             #
#   ** ** #  *#
#   ** ** #E *#
#   ** ** #E *#
#   ** ** #  *#
###############